g g g w w g g s s g g g g w w g g s s g g g g w w g g s s g
g g w w w w g s s g g g w w w w g s s g g g w w w w g s s g
g g g s s g g g s g g g w w w w g s s g g g w w w w g s s g
g g g s s g g g s g g g w w w w g s s g g g w w w w g s s g
g g g s s g g g s g g g g s s g g g s g g g g s s g g g s g
g g g s s g g g s g g g w w w w g s s g g g w w w w g s s g
g g g s s g g g s g g g g s s g g g s g g g g s s g g g s g
g g g w w g g s s g g g g w w g g s s g g g g w w g g s s g
g g w w w w g s s g g g w w w w g s s g g g w w w w g s s g
g g g s s g g g s g g g w w w w g s s g g g w w w w g s s g
g g g s s g g g s g g g g s s g g g s g g g g s s g g g s g
g g g w w g g s s g g g g w w g g s s g g g g w w g g s s g
g g w w w w g s s g g g w w w w g s s g g g w w w w g s s g
g g g s s g g g s g g g w w w w g s s g g g w w w w g s s g
g g g s s g g g s g g g w w w w g s s g g g w w w w g s s g
g g g s s g g g s g g g g s s g g g s g g g g s s g g g s g
g g g s s g g g s g g g w w w w g s s g g g w w w w g s s g
g g g s s g g g s g g g g s s g g g s g g g g s s g g g s g
g g g w w g g s s g g g g w w g g s s g g g g w w g g s s g
g g w w w w g s s g g g w w w w g s s g g g w w w w g s s g
g g g s s g g g s g g g w w w w g s s g g g w w w w g s s g
g g g s s g g g s g g g g s s g g g s g g g g s s g g g s g